
   #   #           #   # 
                  


  #     #         #     #..
   #####           #####




           #   # 
          


          #     #
           #####
